0,1,1,1,1,1,1,1,1,1,1,1,1,1,1,1,1,1,1,1,2
3,4,4,4,4,4,4,4,4,4,4,4,4,4,4,4,4,4,4,4,5
3,0,0,0,0,0,0,0,0,0,0,0,0,0,0,0,0,0,0,0,5
3,0,0,0,0,0,0,0,0,0,0,0,0,0,0,0,0,0,0,0,5
3,0,0,0,0,0,0,0,0,0,0,0,0,0,0,0,0,0,0,0,5
3,0,0,0,0,0,0,0,0,0,0,0,0,0,0,0,0,0,0,0,5
3,0,0,0,0,0,0,0,0,0,0,0,0,0,0,0,0,0,0,0,5
3,0,0,0,0,0,0,0,0,0,0,0,0,0,0,0,0,0,0,0,5
3,0,0,0,0,0,0,0,0,0,0,0,0,0,0,0,0,0,0,0,5
3,0,0,0,0,0,0,0,0,0,0,0,0,0,0,0,0,0,0,0,5
3,0,0,0,0,0,0,0,0,0,0,0,0,0,0,0,0,0,0,0,5
6,7,7,7,7,7,7,7,7,7,7,7,7,7,7,7,7,7,7,7,8
